###########################################
#.........................          ......#
#.................................       .#
#........................................ #
#.........................................#
#.......##############....................#
#....................#................G...#
#....................#....................#
#....................#....................#
#....................#....................#
#................#####....................#
#.........................................#
#.........................................#
#.........................................#
#.........................................#
#.........................................#
#.........................................#
#.........................................#
#.........................................#
#.........................................#
#.........................................#
#.....................###.................#
#.....................#.#.................#
#.....................#.#.................#
#.........................................#
#.........................................#
#.........................................#
#.........................................#
#.........................................#
#.........................................#
#.........................................#
#.........................................#
#.........................................#
#.........................................#
#.........................................#
#.........................................#
#.........................................#
#.........................................#
###########################################