###########################################
#.........................          ......#
#.................................       .#
#........................................ #
#.........................................#
#.......##############....................#
#....................#................G...#
#....................#....................#
#....................#....................#
#....................#....................#
#................#####....................#
#.........................................#
#.........................................#
#.........................................#
#.........................................#
#.........................................#
#.........................................#
#.........................................#
#.........................................#
#.........................................x
#.........................................x
#.....................###.................#
#.....................#.#.................#
#.....................#.#.................#
#.......................#.................#
#.........................................#
#.........................................#
#.........................................#
#.........................................#
#.........................................#
#.........................................#
#.........................................#
#..................#......................#
#..................##.....................#
#..................#.#....................#
#..................#..#...................#
#.........................................#
#.........................................#
###########################################