#############################
#.......#####################
#.x.....#####################
#.....G.#####################
#############################
#.......#####################
#.x.....#####################
#.......#####################
#.....G.#####################
#############################
